
1,4,0,0,-1
2,5,0,0,-1
3,6,0,0,-1
4,7,0,0,-1
5,8,10,0,-1
6,9,16,0,-1
7,10,13,0,-1
8,11,19,0,-1
9,12,7,0,-1
10,13,0,0,-1
11,14,0,0,-1
12,15,0,0,-1
13,16,1,0,-1
14,17,4,0,-1
15,18,0,0,-1
16,19,22,0,-1
